###############
#             #
#   XXX       #
#   X    XXX  #
P   X      X  #
#   XXX    X  #
#        XXX  #
#             #
###############