###############
#             #
#             #
#             #
#             P
#             #
#             #
#             #
#######P#######