###############
# XX        OO#
#  XX        O#
#   X         #
#             P
#   X         #
#  XX        O#
# XX        OO#
#######P#######