###############
#      XX  X  #
#   X      X  #
#   X   X     #
#       X     P
#    X     XX #
#    X        #
#  XX     XX  #
#######P#######