#######P#######
#             #
#             #
#             #
P             #
#             #
#             #
#             #
###############