#######P#######
#             #
#             #
#    OXXXO    #
P    OXOXO    #
#    OXXXO    #
#             #
#             #
###############