#######P#######
#             #
#  O    OO    #
#  O     O    #
P  OO       O #
#      O    O #
#  O   OO   O #
#  O          #
###############