###############
#OO         OO#
#             #
#      X      #
#     XXX     #
#      X      #
#             #
#OO         OO#
#######P#######