###############
#             #
#  XXXXXXXXX  #
#             #
#    XXXXX    #
#             #
#      X      #
#O           O#
#######P#######