#######P#######
#             #
#             #
#             #
#             P
#             #
#             #
#             #
###############