#######P#######
#O            #
#O   X   X    #
#O   X   X    #
#O            P
#O   X   X    #
#O   X   X    #
#O            #
###############