###############
#             #
#     X X     #
#    XX XX    #
P             #
#    XX XX    #
#     X X     #
#             #
#######P#######