#######P#######
#             #
#             #
#             #
P             #
#             #
#             #
#             #
#######P#######