#######P#######
#             #
#             #
#             #
P             P
#             #
#             #
#             #
#######P#######