#######P#######
#             #
#             #
#             #
P             P
#             #
#             #
#             #
###############